4
4
2 0 5 2 1 3
1 3 5 1 2 3
3 0 5 2 3 4
1 2 5 2 0 2
3 2 5 3 2 1
1 1 5 3 2 4
2 0 5 2 3 3
1 3 5 1 3 3
2 3 5 0 0 2
0 2 5 3 3 3
2 0 5 0 1 1
0 1 5 1 0 4
3 2 5 0 2 2
0 1 5 1 3 4
-1 -1 -1 -1 -1 -1